        NO ./path_to_the_north_texture
SO ./path_to_the_south_texture
EA ./path_to_the_east_texture

F 220,100,0
WE ./path_to_the_west_texture


C 225,30,0

        1111111111111111111111111
        1000000000110000000000001
        1011000001110000000000001
        1001000000000000000000001
111111111011000001110000000000001
100000000011000001110111111011111
11110111111111011100000010001
11110111111111011101010010001
11000001110101011100000010001
10000001 10000001100000010001
10000001 10000001101010010001
11000001 10101011111011111N0111
11110111 1110101 1011111 1001
11111111 1111111 1111111 1111